1111       111111111111111
100000C1                   000000000000000001
10E00001000000000000000000001
100000P1000000000000000000001
100 0001000000000000000000001
111111111111111111111111111